的	u
一	f
是	o
不	c
了	r
在	n
我	t
人	j
大	m
中	d
来	a
和	x
说	s
为	i
到	y
就	g
也	e
要	v
可	z
道	h
而	l
得	w
能	k
都	q
如	b
行	p
丁	ad
丰	af
鬼	ag
乙	ai
六	al
皿	amm
门	am
片	ap
舌	as
未	aw
弓	bg
卵	bl
面	bm
女	bn
云	by
不	cb
虫	cc
飞	cf
古	cg
火	ch
支	ci
及	cj
尸	cs
业	cy
口	dk
里	dl
民	dm
无	du
由	dy
干	eg
见	ej
木	em
欠	eq
穴	ex
也	ey
辰	fc
一	fi
且	fq
示	fs
亡	fw
歹	gd
高	gg
句	gj
士	gs
土	gt
韦	gw
羊	gy
八	hb
夫	hf
谷	hg
子	hi
心	hx
册	ic
艮	ig
立	il
舟	io
予	iv
幺	iy
斗	jd
仑	jl
人	jr
入	ju
寸	kc
亥	kh
九	kj
母	km
水	ks
齿	lc
而	le
方	lf
廿	ln
千	lq
生	ls
夕	lx
牙	ly
巴	mb
大	md
二	me
光	mg
户	mh
两	ml
犬	mq
石	ms
黄	nh
马	nm
十	ns
王	nw
辛	nx
贝	ob
川	oc
自	oi
几	oj
日	or
矢	os
尤	oy
长	pc
刀	pd
儿	pe
戈	pg
黑	ph
弋	pi
米	pm
鼠	ps
足	pu
行	px
走	pz
臣	qc
耳	qe
井	qj
老	ql
目	qm
牛	qn
齐	qq
食	qs
田	qt
非	rf
之	ri
巾	rj
了	rl
皮	rp
七	rq
竹	ru
瓦	rw
又	ry
各	sg
止	si
力	sl
尚	ss
言	sy
弗	tf
革	tg
衣	ti
斤	tj
龙	tl
三	ts
雨	tv
用	ty
白	ub
工	ug
手	us
匕	vb
已	vi
乃	vn
气	vq
山	vs
巳	vss
文	vw
西	vx
月	vy
乍	wa
五	wu
象	wx
页	wy
厂	xc
广	xg
鹿	xl
鸟	xn
束	xs
音	xy
爪	ya
卜	yb
车	yc
瓜	yg
至	yi
曲	yq
四	ys
小	yx
酉	yy
豆	zd
甘	zg
金	zj
可	zk
麻	zm
身	zs
羽	zv
习	zx
乱	aae
魅	aaw
交	abi
疟	abj
妆	abn
舐	abs
耘	aby
闽	acc
问	adk
闲	aem
刁	afi
刁	afie
闩	afi
闩	afim
疽	afq
壮	ags
丑	agt
痒	agy
来	ahb
麦	ahi
敌	ahp
闷	ahx
痕	aig
素	ais
魁	ajd
闪	ajr
寿	akc
阂	akh
毒	akm
疤	ambb
耙	ambl
状	amq
闯	anm
闰	anw
辞	anx
责	aob
间	aor
疾	aos
疣	aoy
刮	apd
闻	aqe
耕	aqj
疗	arl
疲	arp
疫	ars
阁	asg
闸	asj
邦	ate
表	ati
适	auc
缸	aug
北	avb
耗	avm
闵	avw
青	avy
顶	awy
痘	azd
甜	azg
卸	azj
魂	bag
妹	baw
妇	bbj
姑	bcg
灵	bch
妓	bci
如	bdk
妩	bdu
奸	beg
杀	bem
她	beyn
弛	beyg
娠	bfc
姐	bfq
引	bgs
好	bhi
姗	bic
氐	bid
卿	big
寻	bkc
姆	bkm
弘	bks
弘	bksg
录	bks
录	bksj
隶	bks
隶	bksv
弃	blc
妨	blf
姓	bls
妒	bmh
凶	bmk
卯	bmm
妈	bnm
贸	bob
昏	bor
张	bpc
充	bpe
姬	bqc
姥	bql
留	bqt
奴	bry
动	bsl
氏	bss
姊	btf
尹	btp
运	buc
建	buy
妃	bvj
奶	bvn
聿	bvv
育	bvy
弧	byg
乐	byx
灯	cad
虬	cae
蚌	caf
蛊	cam
层	cby
烛	ccc
居	ccg
炎	cch
否	cdk
蝇	cdm
届	cdy
炊	ceq
丕	cfi
蛆	cfq
灶	cgt
故	chp
尺	cid
蚪	cjd
尿	cks
炉	cmh
蚂	cnm
辜	cnx
贵	cob
克	cpe
屎	cpm
眉	cqm
烙	csg
邺	cte
甭	cty
还	cuc
虹	cug
尼	cvb
尾	cvm
灿	cvs
蚊	cvw
胡	cvy
炸	cwa
烦	cwy
屋	cyi
屋	cyis
蛭	cyi
蛭	cyic
蛐	cyq
翅	czv
叮	dad
味	daw
史	dbi
虽	dcc
咕	dcg
吱	dci
吸	dcj
吕	ddk
哩	ddl
呆	dem
吹	deq
咀	dfq
中	dgs
吐	dgt
只	dhb
只	dhbv
叭	dhb
叭	dhbb
叫	dij
野	div
吆	diy
咳	dkh
啮	dlc
呀	dly
吧	dmb
吧	dmbb
邑	dmb
邑	dmby
咣	dmg
吠	dmq
哺	dnf
吗	dnm
叶	dns
呈	dnw
呗	dob
呗	dobb
员	dob
员	doby
咱	doi
叽	doj
叨	dpd
兄	dpe
嘿	dph
咪	dpm
啡	drf
吊	drj
叹	dry
咯	dsg
呷	dsj
另	dsl
邮	dte
听	dtj
咙	dtl
迪	duc
唯	dui
叱	dvb
哂	dvx
胄	dvy
咋	dwa
鸣	dxn
呜	dxu
呱	dyg
唬	dzh
叩	dzj
呵	dzk
嘛	dzm
札	eae
窑	eaf
槐	eag
乞	eai
穹	ebg
柳	ebm
杯	ecb
枯	ecg
杰	ech
枝	eci
极	ecj
杏	edk
杆	eeg
林	eem
杉	ees
本	efi
标	efs
杜	egt
样	egy
平	ehb
李	ehi
枚	ehp
栅	eic
术	eid
根	eig
村	ekc
核	ekh
究	ekj
每	ekm
穿	ely
突	emq
横	enh
午	ens
枉	enw
梓	enx
机	eoj
杳	eor
刊	epd
相	eqm
帘	erj
权	ery
格	esg
穷	esl
析	etj
柏	eub
杠	eug
杠	eugm
空	eug
空	eugx
椎	eui
杞	evj
年	evk
栖	evx
窄	ewa
橡	ewx
须	ewy
朴	eyb
窒	eyi
柑	ezg
柯	ezk
栩	ezv
礼	fae
丈	fbi
互	fbj
妄	fbn
蜃	fcc
骷	fcg
灭	fch
亚	fcy
唇	fdk
氓	fdm
视	fej
末	fem
祖	ffq
骨	fgg
社	fgt
祥	fgy
敝	fhp
忘	fhx
辱	fkc
骸	fkh
县	fks
开	flc
天	fmd
于	fns
万	fpd
兀	fpe
盲	fqm
骰	frs
屯	fsc
骼	fsg
正	fsi
助	fsl
祁	fte
祁	ftei
邙	fte
邙	ftew
祈	ftj
百	fub
祀	fvs
祚	fwa
下	fyb
亭	gad
羌	gae
盖	gam
姜	gbn
坛	gby
坏	gcb
羔	gch
羔	gchy
赤	gch
赤	gcht
圾	gcj
声	gcs
吉	gdk
埋	gdl
坎	geq
地	gey
圭	ggt
幸	ggy
享	ghi
敲	ghp
志	ghx
志	ghxs
恙	ghx
恙	ghxy
垃	gil
豪	gjs
寺	gkc
去	gks
坊	glf
歼	glq
美	gmd
埔	gnf
坝	gob
圳	goc
亮	goj
旧	gor
列	gpd
着	gqm
亨	grl
坡	grp
殁	grs
址	gsi
违	guc
差	gug
堆	gui
死	gvb
毫	gvm
坟	gvw
膏	gvy
坞	gxu
京	gyx
坷	gzk
翔	gzv
孔	hae
愧	hag
忆	hai
孟	ham
恬	has
父	hbi
怀	hcb
鼓	hci
喜	hdk
规	hej
条	hem
欲	heq
彭	hes
祭	hfs
忙	hfw
丫	hgs
夹	hhb
孜	hhp
恨	hig
忖	hkc
孩	hkh
公	hks
并	hlc
忏	hlq
性	hls
关	hmd
恍	hmg
首	hoi
忧	hoy
怅	hpc
分	hpd
备	hqt
恪	hsg
务	hsl
弟	htf
忻	htj
必	htp
兰	hts
怕	hub
惟	hui
半	hus
冬	hwb
悚	hxs
处	hyb
孤	hyg
孙	hyx
酋	hyy
登	hzd
幻	iae
盘	iam
义	ibi
缅	ibm
妾	ibn
纸	ibs
纭	iby
级	icj
童	idl
绳	idm
既	idu
舰	iej
亲	iem
组	ifq
垦	igt
纬	igw
典	ihb
收	ihp
恳	ihx
良	iig
纠	iij
丝	iis
纶	ijl
纣	ikc
永	iks
纺	ilf
纺	ilfs
舫	ilf
舫	ilfo
纤	ilq
主	inw
删	ipd
细	iqt
绯	irf
般	irs
络	isg
幼	isl
矛	itp
舶	iub
退	iuc
红	iug
维	iui
纪	ivj
纹	ivw
豫	iwx
预	iwy
产	ixc
乡	ixx
即	izj
翊	izv
今	jae
傀	jag
亿	jai
们	jam
舍	jas
会	jby
估	jcg
伙	jch
伎	jci
合	jdk
俚	jdl
休	jem
他	jey
个	jgs
个	jgsg
仕	jgs
仕	jgsu
伟	jgw
佯	jgy
俗	jhg
仔	jhi
位	jil
伦	jjl
从	jjr
付	jkc
仇	jkj
令	jks
仿	jlf
伢	jly
仁	jme
俩	jml
伏	jmq
什	jns
全	jnw
优	joy
介	jpd
伐	jpg
代	jpi
促	jpu
佬	jql
件	jqn
佃	jqt
仅	jry
企	jsi
倘	jss
信	jsy
佛	jtf
依	jti
佣	jty
伯	jub
逐	juc
化	jvb
仍	jvn
仙	jvs
作	jwa
伍	jwu
像	jwx
余	jxh
仆	jyb
侄	jyi
仓	jzj
何	jzk
汀	kad
沣	kaf
益	kam
活	kas
汝	kbn
津	kbv
浊	kcc
沽	kcg
汲	kcj
台	kdk
泯	kdm
油	kdy
汗	keg
杂	kem
杂	kemj
沐	kem
沐	kems
池	key
滑	kfg
沮	kfq
洋	kgy
兴	khb
浴	khg
沁	khx
丸	kid
泣	kil
沦	kjl
弁	klc
汐	klx
沪	kmh
浦	knf
汇	knk
汁	kns
汪	knw
贯	kob
旭	kor
旭	korj
汩	kor
汩	kors
汩	korg
沓	kor
沓	kord
矣	kos
刻	kpd
允	kpe
泪	kqm
牟	kqn
济	kqq
波	krp
没	krs
汉	kry
洛	ksg
劾	ksl
淌	kss
沸	ktf
沂	ktj
甬	kty
泊	kub
过	kuc
江	kug
淮	kui
毋	kuu
汽	kvq
汕	kvs
汶	kvw
洒	kvx
渔	kwv
漉	kxl
鸠	kxn
泗	kys
酒	kyy
河	kzk
世	lae
艺	lai
艾	lbi
耍	lbn
芸	lby
茧	lcc
苦	lcg
名	ldk
重	ldl
芜	ldu
芒	lfw
蒿	lgg
苟	lgj
苇	lgw
共	lhb
芙	lhf
放	lhp
芯	lhx
龈	lig
耐	lkc
芳	llf
多	llx
芽	lly
芭	lmb
芦	lmh
茂	lnu
莘	lnx
昔	lor
熏	lph
茸	lqe
苗	lqt
菲	lrf
芝	lri
芷	lsi
卅	lss
邪	lte
芹	ltj
迁	luc
雅	lui
茜	lvx
鸦	lxn
外	lyb
节	lzj
苛	lzk
亏	mae
夷	mbg
冈	mbi
独	mcc
狄	mch
启	mdk
狸	mdl
砚	mej
砍	meq
猾	mfg
凹	mfi
狙	mfq
奈	mfs
狗	mgj
冉	mgt
扁	mic
太	mid
狠	mig
内	mjr
夺	mkc
泵	mks
房	mlf
央	mmd
戾	mmq
磺	mnh
码	mnm
狂	mnw
狈	mob
矶	moj
犹	moy
套	mpc
元	mpe
耷	mqe
奋	mqt
扉	mrf
破	mrp
狒	mtf
所	mtj
所	mtjh
斫	mtj
斫	mtjs
达	muc
雇	mui
肩	mvy
硕	mwy
矿	mxg
狐	myg
犯	mzj
犯	mzjq
犯	mzjf
奇	mzk
丹	mzt
扇	mzv
成	nae
瑰	nag
区	nbi
环	ncb
融	ncc
灰	nch
右	ndk
右	ndks
叵	ndk
叵	ndkk
理	ndl
现	nej
勿	nes
驰	ney
甫	nff
戌	nfi
驹	ngj
玫	nhp
珊	nic
勺	nid
勺	nidk
戍	nid
戍	nidu
玉	nid
玉	nidw
骇	nkh
勾	nks
卉	nlc
卉	nlcs
弄	nlc
弄	nlcw
驮	nmd
驴	nmh
匍	nnf
璜	nnh
巨	nnk
玛	nnm
匡	nnw
驯	noc
玑	noj
旬	nor
医	nos
匹	npe
臧	nqc
珥	nqe
甸	nqt
匪	nrf
匝	nrj
匝	nrjk
布	nrj
布	nrjs
玻	nrp
友	nry
友	nrys
驭	nry
驭	nrym
骆	nsg
匣	nsj
匠	ntj
珑	ntl
才	ntp
珀	nub
左	nug
戊	nuu
包	nvs
有	nvy
匀	nwb
顼	nwy
辣	nxs
琥	nzh
珂	nzk
电	oae
昧	oaw
风	obi
昙	oby
显	ocy
知	odk
旱	oeg
朵	oem
晨	ofc
晨	ofcr
赈	ofc
赈	ofcb
旦	ofi
夙	ogd
申	ogs
败	ohp
息	ohx
凡	oid
时	okc
星	ols
晃	omg
臭	omq
早	ons
旺	onw
州	ooc
昌	oor
账	opc
则	opd
冒	oqm
曰	orr
凤	ory
赂	osg
是	ots
巡	ouc
雉	oui
晒	ovx
明	ovy
昨	owa
顺	owy
旷	oxg
暗	oxy
短	ozd
赵	pbi
归	pbj
娄	pbn
肆	pbv
召	pdk
赶	peg
粗	pfq
墨	pgt
趴	phb
籽	phi
忒	phx
跚	pic
刃	pid
跟	pig
粒	pil
料	pjd
臼	pjj
衍	pks
戒	plc
类	pmd
默	pmq
戎	pns
越	pnu
划	ppd
跻	pqq
帅	prj
跛	prp
路	psg
趾	psi
趟	pss
迷	puc
式	pug
起	pvj
衡	pwv
黯	pxy
赴	pyb
衔	pzj
町	qad
町	qadt
盯	qad
盯	qadm
聊	qbm
蚀	qcc
耿	qch
告	qdk
眠	qdm
果	qem
饮	qeq
犒	qgg
牡	qgt
具	qhb
孝	qhi
牧	qhp
思	qhx
眼	qig
累	qis
牲	qls
饥	qoj
者	qor
者	qorv
耆	qor
耆	qorl
耆	qorq
剂	qpd
先	qpe
眯	qpm
饵	qqe
取	qry
略	qsg
耻	qsi
男	qsl
耶	qte
进	quc
睢	qui
禺	qvr
牺	qvx
胃	qvy
颐	qwy
卧	qyb
固	rcg
笈	rcj
回	rdk
笛	rdy
竿	reg
观	rej
困	rem
欢	req
韭	rfi
圣	rgt
围	rgw
悲	rhx
叉	rid
艰	rig
笠	ril
囚	rjr
对	rkc
笙	rls
笆	rmb
因	rmd
竺	rme
圃	rnf
簧	rnh
笃	rnm
帐	rpc
切	rpd
戏	rpg
双	rry
劝	rsl
邓	rte
第	rtf
裴	rti
笼	rtl
帕	rub
辽	ruc
帷	rui
帷	ruij
难	rui
难	ruiy
笔	rvm
斐	rvw
颇	rwy
鸡	rxn
辈	ryc
东	ryx
翡	rzv
订	sad
话	sas
尝	sby
歧	sci
加	sdk
棠	sem
诅	sfq
堂	sgt
讳	sgw
详	sgy
办	shb
敞	shp
甲	sjj
论	sjl
认	sjr
讨	skc
该	skh
访	slf
讶	sly
出	smk
计	sns
赏	sob
训	soc
讥	soj
党	spe
讲	sqj
诽	srf
常	srj
设	srs
步	ssi
裳	sti
边	suc
谁	sui
谁	suiy
雒	sui
雒	suig
掌	sus
此	svb
记	svj
讪	svs
肯	svy
诈	swa
鸭	sxn
谙	sxy
诃	szk
诩	szv
甩	tae
血	tam
朱	taw
雪	tbj
蛋	tcc
哀	tdk
袖	tdy
欣	teq
衫	tes
震	tfc
丘	tfi
阻	tfq
际	tfs
壬	tgs
垄	tgt
兵	thb
失	thf
裕	thg
斥	tid
限	tig
系	tis
队	tjr
衬	tkc
么	tks
升	tlc
需	tle
防	tlf
靶	tmb
夭	tmd
隔	tng
费	tob
阳	tor
初	tpd
陡	tpz
聋	tqe
阱	tqj
雷	tqt
乏	tri
币	trj
被	trp
勒	tsl
袭	tti
靳	ttj
陇	ttl
近	tuc
霍	tui
雯	tvw
胥	tvy
胥	tvys
阴	tvy
阴	tvye
补	tyb
阵	tyc
阿	tzk
打	uad
扎	uae
魄	uag
扪	uam
括	uas
扫	ubj
焦	uch
技	uci
售	udk
售	udki
扣	udk
扣	udks
抿	udm
抚	udu
抽	udy
集	uem
振	ufc
搞	ugg
拘	ugj
扒	uhb
扶	uhf
攻	uhp
拉	uil
抒	uiv
抖	ujd
抡	ujl
拇	ukm
汞	uks
汞	uksg
泉	uks
泉	uksb
把	umb
护	umh
击	umk
拓	ums
捕	unf
隼	uns
皇	unw
贡	uob
扰	uoy
找	upg
捉	upu
看	uqm
挤	uqq
排	urf
帛	urj
披	urp
皂	urq
投	urs
扯	usi
押	usj
功	usl
拂	utf
折	utj
拢	utl
拥	uty
拍	uub
迫	uuc
扛	uug
推	uui
扔	uvn
扔	uvns
隽	uvn
隽	uvni
项	uwy
扩	uxg
抓	uya
扑	uyb
腼	vbm
要	vbn
炙	vch
岐	vci
岐	vcis
肢	vci
肢	vciy
岌	vcj
吝	vdk
岷	vdm
肝	veg
栗	vem
凸	vfi
票	vfs
嵩	vgg
肚	vgt
氧	vgy
肤	vhf
峪	vhg
孕	vhi
改	vhp
忌	vhx
紊	vis
己	vjj
以	vjr
豚	vjs
导	vkc
导	vkcs
肘	vkc
肘	vkcy
氦	vkh
异	vlc
斋	vle
肪	vlf
胜	vls
岁	vlx
肥	vmb
胱	vmg
毛	vmm
岩	vms
脯	vnf
贾	vob
肌	voj
旨	vor
胀	vpc
刘	vpd
粟	vpm
脐	vqq
腓	vrf
股	vrs
胳	vsg
岬	vsj
肋	vsl
氟	vtf
胧	vtl
这	vuc
肛	vug
崔	vui
比	vvb
岂	vvj
氖	vvn
朋	vvy
顷	vwy
宁	wad
安	wbn
律	wbv
灾	wch
吾	wdk
鲤	wdl
宙	wdy
宋	wem
次	weq
宸	wfc
宜	wfq
宗	wfs
龟	wgg
鲜	wgy
容	whg
字	whi
怎	whx
很	wig
家	wjs
守	wkc
官	wki
冰	wks
彷	wlf
头	wmd
宕	wms
冯	wnm
宰	wnx
冗	woj
鲁	wor
免	wpe
徒	wpz
宦	wqc
牢	wqn
徘	wrf
彼	wrp
役	wrs
客	wsg
农	wti
宠	wtl
定	wts
兔	wtt
逸	wuc
准	wui
它	wvb
鱼	wvv
冤	wwt
稣	wxh
军	wyc
室	wyi
厅	xad
秉	xbj
委	xbn
争	xbv
秋	xch
和	xdk
厘	xdl
庙	xdy
秆	xeg
床	xem
床	xemg
枭	xem
枭	xemn
歆	xeq
租	xfq
稿	xgg
庄	xgt
柬	xhb
禾	xhh
季	xhi
敕	xhp
意	xhx
久	xid
序	xiv
科	xjd
仄	xjr
私	xks
色	xmb
庆	xmd
庐	xmh
厌	xmq
章	xns
负	xob
秃	xoj
香	xor
利	xpd
利	xpdh
剌	xpd
剌	xpds
竟	xpe
反	xry
历	xsl
邝	xte
邝	xteg
邬	xte
邬	xteu
袅	xti
庞	xtl
角	xty
速	xuc
稚	xui
乌	xuu
秀	xvn
岛	xvs
库	xyc
尔	xyx
厄	xzj
轧	yae
当	ybj
妥	ybn
酝	yby
卢	ycs
占	ydk
轴	ydy
轩	yeg
觅	yej
采	yem
软	yeq
上	yfi
尘	ygt
孚	yhi
致	yhp
轮	yjl
轨	ykj
罗	ylx
爬	ymb
尖	ymd
辆	yml
辅	ynf
贞	yob
到	ypd
舀	ypj
罪	yrf
酪	ysg
郅	yte
斩	ytj
少	ytp
连	yuc
雀	yui
配	yvj
肖	yvy
酥	yxh
辘	yxl
酣	yzg
轲	yzk
钉	zad
魔	zag
躬	zbg
虐	zbj
亦	zch
虚	zcy
铀	zdy
某	zem
钦	zeq
彪	zes
卫	zfi
镐	zgg
其	zhb
虎	zhh
虑	zhx
银	zig
翌	zil
玄	ziy
射	zkc
磨	zms
铺	znf
针	zns
锌	znx
钡	zob
亢	zoj
钊	zpd
糜	zpm
亩	zqt
靡	zrf
市	zrj
殷	zrs
铬	zsg
钾	zsj
虏	zsl
躺	zss
邯	zte
逗	zuc
翟	zui
翟	zuix
锥	zui
锥	zuij
摩	zus
麾	zvm
虔	zvw
钥	zvy
卞	zyb
钳	zzg
哥	zzk
慧	aabh
彗	aabj
痫	aaem
疡	aaes
书	aagi
阚	aaqh
效	abhp
瘤	abqt
郊	abte
痰	acch
痞	acdk
癖	acdn
闾	addk
癌	addv
疙	aeai
司	afdk
舔	afmh
病	afmj
症	afsi
闺	aggt
痣	aghx
阖	agka
痔	agkc
装	agti
阅	ahdp
阐	ahqn
阙	ahse
疼	ahwb
奏	aifm
泰	aiks
蠢	aioc
春	aior
瘢	airs
奉	aius
秦	aixh
疹	ajes
痊	ajnw
阀	ajpg
疮	ajzj
阔	akas
丞	akfi
函	akmk
兖	akpe
承	akts
痛	akty
牒	alae
罐	aldu
桨	alem
瘩	aljd
瘀	aljw
将	alkc
浆	alks
奖	almd
酱	alyy
阉	amoa
牍	anam
缺	anjr
癫	anqw
闭	antp
迅	anuc
疱	anvs
瘟	aoam
疯	aobi
痴	aodk
瘪	aojl
瘦	apgr
熬	aphc
赘	apho
敖	aphp
鳌	aphw
契	apmd
憨	aqhh
敢	aqhp
痹	aqlc
痉	arug
瘫	arui
瘸	asdj
疵	asvb
虱	atcc
帮	atrj
瘾	atxh
那	aute
牌	autn
冀	avqh
背	avvy
静	avxb
癣	awgy
买	awmd
瘠	awwv
阑	axhb
疚	axid
艳	axmb
痪	axmm
瘴	axns
痢	axpd
阎	axpj
版	axry
癞	axxo
闹	azrj
姣	babi
娴	baem
妞	bagt
嫉	baos
婊	bati
娜	baut
樊	bbem
攀	bbeu
婚	bbor
媚	bcqm
妮	bcvb
娓	bcvm
强	bdcc
娉	bdfa
娱	bdfm
恕	bdhx
絮	bdis
娲	bdmj
娟	bdvy
刹	bepd
弑	bepu
婕	bfbs
娅	bfcy
妍	bflc
嫣	bfsc
印	bfzj
婷	bgad
疆	bgff
娃	bggt
嫌	bhbc
嬉	bhdk
婵	bhqn
弹	bhq
弹	bhqg
娘	biig
嫡	bimc
邸	bite
蠡	bjcc
始	bkdk
剥	bkpd
逮	bkuc
姨	bmbg
希	bnrj
肴	bnvy
妲	bofi
媳	bohx
娼	boor
嫂	bpgr
肃	bphb
彝	bpil
姚	bpww
弩	brbg
怒	brhx
姻	brmd
努	brsl
嫦	bsrj
群	btdg
君	btdk
郡	btdt
妊	btgs
妖	btmd
娇	btmp
媲	btrv
娥	btup
婿	btvy
婀	btzk
兜	bunp
婢	butn
嫖	bvfs
弱	bwbw
嫁	bwjs
婉	bwlz
婶	bwog
娩	bwpe
帚	bwrj
嫔	bwth
嫩	bxhp
弥	bxyx
媛	byfr
孵	byhi
妙	bytp
媒	bzem
弦	bziy
嬷	bztk
迎	bzuc
蛟	cabi
局	cadk
炀	caes
蜻	cavy
蚓	cbgs
烯	cbnr
烁	cbyx
烬	cciw
剧	ccpd
蝴	ccvy
燥	cdde
蜈	cdfm
炽	cdhb
蜗	cdmj
壁	cdng
璧	cdni
劈	cdnp
譬	cdns
擘	cdnb
避	cdnc
避	cdnu
臂	cdnv
辟	cdnx
蜥	cetj
蝠	cfdq
尉	cfkc
慰	cfkh
炳	cfmj
炖	cfsc
歪	cfsi
虾	cfyb
蛙	cggt
蟮	cghd
凿	cgmk
烽	chaf
烽	chah
蜂	chaf
蜂	chac
蜕	chdp
蜷	chhz
蚣	chks
屏	chlc
蝉	chqn
烂	chts
蚁	cibi
咫	cidh
焙	cidk
螂	ciit
熵	cimd
蛀	cinw
昼	ciof
迟	ciuc
尽	ciwb
螃	ciwl
蛤	cjdk
犀	ckqn
蛹	ckty
遣	ckuc
屉	clae
屉	clas
蝶	clae
蝶	clac
烘	clhb
殿	clhr
臀	clhv
蟒	clml
蟆	clom
蜡	clor
展	clti
炯	cmdk
燎	cmhy
蝙	cmic
遐	cmnu
煽	cmzv
灼	cnid
炬	cnnk
炮	cnvs
蜘	codk
焊	coeg
熄	cohx
熄	cohh
螅	cohx
螅	cohc
煜	coil
爆	colk
蝎	conf
遗	couc
屡	cpbn
兢	cpcp
烧	cpfp
烤	cqfa
螺	cqis
屠	cqor
蛔	crdk
烟	crmd
刷	crpd
炼	cryx
螳	csgt
屈	csmk
蛛	ctaw
属	ctdv
蚯	ctfi
蜓	ctgu
蠕	ctle
蟋	ctph
蟠	ctpq
蜒	ctsu
蛾	ctup
煌	cunw
煌	cunh
蝗	cunw
蝗	cunc
燃	cvmc
屁	cvvb
履	cweh
煊	cwff
熔	cwhg
蜿	cwlz
蛇	cwvb
蝌	cxjd
焕	cxmm
蟑	cxns
焰	cxpj
蟾	cxxs
炒	cytp
屑	cyvy
螭	czbv
煤	czem
蟀	czin
炫	cziy
炕	czoj
熠	czub
咬	dabi
叼	dafi
啧	daob
嗷	daph
哪	daut
喙	dbjs
唏	dbnr
啸	dbph
唷	dbvy
噼	dcdn
呸	dcfi
噗	dcgi
唰	dcrp
嘱	dctv
呢	dcvb
喔	dcyi
噪	ddde
品	dddk
患	ddgh
串	ddgs
器	ddmd
哭	ddmq
鄂	ddmt
颚	ddmw
鹗	ddmx
骂	ddnm
咒	ddoj
嚣	ddwd
吃	deai
噤	deef
喳	deof
号	dfae
饕	dfaq
哑	dfcy
吴	dfmd
吁	dfns
哽	dfob
嘎	dfop
吨	dfsc
吓	dfyb
嘈	dfyo
盅	dgam
哧	dgch
哇	dggt
忠	dghx
嚎	dgjs
咧	dgpd
哼	dgrl
嗟	dgug
噎	dgwz
吼	dhae
嘻	dhdk
嘭	dhes
嗡	dhkz
吩	dhpd
咚	dhwb
嗣	diad
墅	digt
咝	diis
啷	diit
咏	diks
嘀	dimc
哟	dini
啼	diwr
唧	dizj
吟	djae
啥	djas
哈	djdk
咻	djem
啄	djid
咐	djkc
喉	djno
哗	djvn
喻	djvp
呛	djzj
噙	djzv
嗨	dkek
唆	dkhh
唉	dkos
吮	dkpe
哞	dkqn
啵	dkrp
喋	dlae
哎	dlbi
哄	dlhb
嗒	dljd
嗬	dljz
唾	dllg
哆	dllx
喏	dlnd
噶	dlof
喵	dlqt
唠	dlws
咦	dmbg
呐	dmjr
哒	dmuc
呕	dnbi
囔	dndt
吻	dnes
喊	dnfd
喷	dnlo
喃	dnmg
嘲	dnov
嗔	dnqh
咂	dnrj
鄙	dnrt
郢	dnte
逞	dnuc
咆	dnvs
嗦	dnwi
嚏	dnwt
呻	dogs
嗅	domq
喝	donf
嘤	doob
唱	door
勋	dosl
喽	dpbn
嗖	dpgr
喂	dqft
哮	dqhi
嗜	dqor
嘟	dqot
嗫	dqrr
喟	dqvy
咽	drmd
嗯	drmh
嗓	drre
啜	drrr
噬	druj
咖	dsdk
嗤	dsfc
咄	dsmk
别	dspd
嘴	dsvt
啃	dsvy
嚷	dtdf
呼	dthn
嚅	dtle
响	dtmd
噢	dtmm
哦	dtup
啊	dtzk
啦	duil
嗥	dumn
啤	dutn
啪	duub
喘	dvle
鹃	dvxn
咛	dwad
咛	dwan
嗐	dwad
嗐	dwah
唔	dwdk
喧	dwff
嚓	dwhf
噜	dwor
喀	dwsg
哝	dwti
啾	dxch
嗽	dxeq
噫	dxhx
唤	dxmm
喇	dxpd
呃	dxzj
咔	dyfy
吵	dytp
哨	dyvy
嗳	dywr
嚼	dyyk
嘘	dzcy
嘶	dzht
啐	dzjn
吭	dzoj
校	eabi
榈	eadd
杨	eaes
椿	eaio
棒	eaiu
楔	eapm
橄	eaqh
梆	eate
迄	eauc
椽	ebjs
棣	ebks
梳	eboc
榴	ebqt
窘	ebtd
楣	ecqm
窟	ecsm
窜	eddg
窝	edmj
婪	eebn
焚	eech
森	eeem
彬	eees
禁	eefs
梅	eekm
梦	eelx
杵	eens
梵	eeoi
楚	eets
榨	eewa
麓	eexl
朽	efae
杖	efbi
柄	efmj
梗	efob
桓	efof
栈	efpg
槽	efyo
桔	egdk
桂	eggt
棱	eghh
椋	egyx
窥	ehej
邃	ehju
松	ehks
梯	ehtf
栏	ehts
橙	ehzd
概	eidu
榔	eiit
柱	einw
窈	eisl
橘	eitd
述	eiuc
榜	eiwl
桧	ejby
检	ejkf
栓	ejnw
桦	ejvn
榆	ejvp
枪	ejzj
毓	ekbo
梭	ekhh
繁	ekhi
敏	ekhp
桶	ekty
舞	elfv
模	elom
檬	elwj
棘	emem
桐	emfd
刺	empd
枣	emwb
椅	emzk
窦	enam
枢	enbi
构	enks
楠	enmg
柜	ennk
框	ennw
植	enqf
材	entp
枫	eobi
查	eofi
复	eohi
樱	eoob
棍	eovv
榻	eozv
楼	epbn
械	eplc
槛	epra
榄	epre
桃	epww
窖	eqdk
棵	eqe
棵	eqem
窠	eqex
窠	eqem
想	eqhx
椰	eqte
树	erkc
窃	erpd
栋	eryx
枷	esdk
株	etaw
窿	ethl
槌	etku
桥	etmp
椭	etnv
窗	etrh
皙	etub
樵	euch
窍	eufa
檄	eulh
棉	eurj
楷	evvu
橇	evvv
棚	evvy
柠	ewad
梧	ewdk
棕	ewfs
榕	ewhg
棺	ewki
橹	ewor
枕	ewpe
槟	ewth
榷	ewui
桩	exgt
樟	exns
板	exry
檐	exxs
桅	exxz
橱	exzk
档	eybj
椒	eyfr
楞	eylf
桢	eyob
梢	eyvy
棋	ezhb
榭	ezkc
杭	ezoj
檀	ezrf
柿	ezrj
祠	fafd
欤	fafe
与	fafi
祷	fakc
妻	fbbn
祗	fbid
禄	fbks
恶	fchx
晋	fcor
严	fcxc
吏	fdbi
事	fdbv
祸	fdmj
祝	fdpe
副	fdqp
逼	fdqu
嬴	fdvb
赢	fdvo
福	ffdq
祛	fgks
禧	fhdk
憋	fhhx
弊	fhlc
蹩	fhpu
瞥	fhqm
禅	fhqn
鳖	fhwv
悬	fkhx
求	fkid
救	fkih
裘	fkit
形	fles
刑	flpd
型	flpg
邢	flte
蚕	fmcc
吞	fmdk
再	fmgt
丙	fmjr
盂	fnam
迂	fnuc
髓	fnuu
更	fobi
亘	fofi
神	fogs
夏	fohi
戛	fopg
盏	fpam
髅	fpbn
武	fpsi
鹉	fpsx
迈	fpuc
画	fqmk
焉	fsfc
政	fshp
顿	fswy
弼	fubb
望	fvnw
郦	fvvt
丽	fvvy
丐	fyae
忑	fyhx
祯	fyob
曹	fyor
遭	fyou
祺	fzhb
场	gaes
羞	gagt
坯	gcfi
赫	gcgc
羹	gcgm
赦	gchp
馨	gcro
郝	gcte
殒	gdob
袁	gdti
颉	gdwy
圪	geai
坪	gehb
款	gfeq
圩	gfns
埂	gfob
垣	gfof
残	gfpg
墙	gghd
墩	gghh
恚	gghx
壕	ggjs
封	ggkc
卦	ggyb
善	ghdk
逵	ghgu
敦	ghhp
熟	ghkc
塾	ghkg
孰	ghki
睿	ghqm
啬	ghrd
壑	ghrg
增	ghro
郭	ghte
丧	ghti
鹑	ghxn
培	gidk
养	gipd
羚	gjks
殆	gkdk
埃	gkos
劫	gksl
却	gkzj
塔	gljd
够	gllx
垮	gmma
殃	gmmd
坍	gmzt
城	gnae
块	gnjr
堰	gnob
殉	gnor
殖	gnqf
填	gnqh
均	gnwb
鋆	gnwz
垛	goem
坦	gofi
坤	gogs
堤	gots
塌	gozv
烈	gpch
域	gpdf
韧	gpid
裂	gpti
堵	gqor
烹	grch
餐	grqs
殊	gtaw
壤	gtdf
埠	gtkn
壶	gwcy
羡	gweq
壳	gwoj
殡	gwth
懿	gwzh
塘	gxbd
垢	gxfd
羲	gxfp
境	gxpe
坂	gxry
盐	gyam
鹫	gyox
就	gyoy
韬	gypj
墟	gzcy
堪	gzha
坑	gzoj
愫	hais
逢	hauc
悯	havw
情	havy
歉	hbce
兼	hbch
爹	hbll
爸	hbmb
恸	hbsl
斧	hbtj
爷	hbzj
爷	hbzy
釜	hbzj
釜	hbzf
普	hcor
熹	hdch
愕	hdda
忡	hdgs
总	hdhx
兑	hdpe
怦	hehb
悔	hekm
兮	hfae
癸	hfmd
恒	hfof
怔	hfsi
悻	hggy
恃	hgkc
怯	hgks
惊	hgyx
悦	hhdp
豢	hhjs
替	hhor
券	hhpd
眷	hhqm
惮	hhqn
憎	hhro
拳	hhus
颊	hhwy
辇	hhyc
卷	hhzj
憧	hidl
慨	hidu
慈	hiih
兹	hiiy
恰	hjdk
怜	hjks
遂	hjuc
愉	hjvp
怆	hjzj
怡	hkdk
惨	hkme
惯	hkob
瓮	hkrw
颂	hkwy
翁	hkzv
慌	hlfo
懂	hlld
惜	hlor
瓶	hlrw
迸	hluc
懵	hlyq
恫	hmfd
惆	hmgd
惘	hmhf
怏	hmmd
郑	hmte
送	hmuc
恢	hnch
惚	hneh
憾	hnfh
惬	hnhh
快	hnjr
愤	hnlo
慎	hnqh
怖	hnrj
惰	hnuv
孢	hnvs
悖	hnwh
愠	hoam
悍	hoeg
憬	hogy
惺	hols
惕	hone
恻	hopd
道	houc
慢	hoyr
盆	hpam
忿	hphx
贫	hpob
掰	hpuu
岔	hpvs
颁	hpwy
兽	hqfd
惧	hqhb
惫	hqhx
单	hqns
冁	hqnt
冁	hqni
郸	hqnt
郸	hqnd
慑	hqrr
怪	hrgt
曾	hryo
嘉	hsdk
夔	hsoh
逆	hsuc
塑	hsvg
朔	hsvy
恤	htam
孺	htle
孺	htli
懦	htle
懦	htlx
懊	htmm
剃	htpd
递	htuc
憔	huch
惶	hunw
判	hupd
叛	huxr
惴	hvle
煎	hvpc
前	hvpd
剪	hvpp
翦	hvpz
恺	hvvj
悟	hwdk
惋	hwlz
忱	hwpe
慷	hxbk
悸	hxhi
懈	hxtq
懒	hxxo
惦	hxyd
咎	hydk
尊	hykc
遵	hyku
愣	hylf
奠	hymd
悼	hyon
惭	hytj
逊	hyuc
悄	hyvy
恼	hzbm
悴	hzjn
凳	hzoj
绞	iabi
纽	iagt
绩	iaob
绑	iate
靖	iavy
缘	ibjs
绿	ibks
统	ibpe
织	idhb
暨	idof
剖	idpd
竞	idpe
缉	idqe
部	idte
绢	idvy
新	ietj
线	ifpg
缰	ifqf
纯	ifsc
结	igdk
缮	ighd
绫	ighh
缝	ihau
纷	ihpd
绊	ihus
绛	ihvk
终	ihwb
绺	ihyd
畿	iipq
郎	iite
朗	iivy
缔	iiwr
绘	ijby
给	ijdk
纵	ijjr
毅	ijrs
舱	ijzj
竣	ikhh
纲	imbi
绸	imgd
商	imhd
缭	imhy
编	imic
纳	imjr
绮	imzk
续	inam
缄	infd
约	inid
缚	inkc
辫	innx
绚	inor
缜	inqh
飒	iobi
船	iodk
绅	iogs
竭	ionf
缨	ioob
继	ipae
缕	ipbn
绍	ipdk
绕	ipfp
艘	ipgr
纫	ipid
绒	ipns
缆	ipre
绪	iqor
磐	irms
缀	irrr
经	irug
绎	irus
练	iryx
为	isid
懋	iteh
柔	item
艇	itgu
矜	itja
缎	iufr
缴	iulh
绵	iurj
缥	ivfs
端	ivle
绷	ivvy
综	iwfs
缩	iwju
绾	iwki
旁	iwlf
啻	iwrd
帝	iwrj
缤	iwth
绽	iwts
舵	iwvb
缠	ixdl
彦	ixes
颜	ixew
绝	ixmb
绣	ixvn
绥	iybn
站	iydk
缓	iyfr
绰	iyon
纱	iytp
绶	iywr
舷	iziy
缪	izje
航	izoj
佼	jabi
含	jadk
颔	jadw
伺	jafd
念	jahx
傣	jaik
俸	jaiu
舒	jaiv
俦	jakc
债	jaob
债	jaor
贪	jaob
贪	jaoi
傲	japh
倩	javy
低	jbid
刽	jbpd
伊	jbtp
健	jbuy
侵	jbwr
仰	jbzj
僻	jcdn
做	jchp
假	jcmr
倔	jcsm
盒	jdam
侣	jddk
僭	jddo
堡	jdeg
保	jdem
仲	jdgs
侃	jdoc
龛	jdtl
拿	jdus
颌	jdwy
鸽	jdxn
命	jdzj
体	jefi
侮	jekm
伤	jesl
仗	jfbi
俨	jfcx
使	jfdb
便	jfob
僵	jfqf
停	jgad
佳	jggt
修	jghe
悠	jghh
倏	jghm
攸	jghp
侍	jgkc
候	jgno
例	jgpd
侠	jhhb
倦	jhhz
伞	jhns
份	jhpd
僧	jhro
伴	jhus
佟	jhwb
仪	jibi
倍	jidk
僮	jidl
住	jinw
伪	jisi
傍	jiwl
丛	jjfi
坐	jjgt
怂	jjhx
众	jjjr
俭	jjkf
伶	jjks
价	jjpd
耸	jjqe
偷	jjvp
敛	jkfh
剑	jkfp
俊	jkhh
俟	jkos
邻	jkte
俑	jkty
领	jkwy
翎	jkzv
供	jlhb
侈	jllx
偌	jlnd
借	jlor
传	jmai
侗	jmfd
僚	jmhy
偏	jmic
俺	jmoa
倚	jmzk
佑	jndk
傅	jnkc
偃	jnob
侯	jnos
值	jnqf
佐	jnug
但	jofi
佩	jofr
伸	jogs
偈	jonf
倡	joor
侧	jopd
侥	jpfp
贷	jpob
倪	jppe
黛	jpph
袋	jpti
岱	jpvs
偎	jqft
俱	jqhb
儡	jqqq
偶	jqvr
傩	jrui
偿	jsby
伽	jsdk
储	jsqo
侏	jtaw
凭	jtgo
凭	jtgp
赁	jtgo
赁	jtgl
任	jtgs
佚	jthf
儒	jtle
侨	jtmp
傻	jtrh
俄	jtup
俾	jutn
似	jvjr
华	jvns
货	jvob
俞	jvpd
愈	jvph
逾	jvpu
催	jvui
偕	jvvu
倾	jvwy
伫	jwfi
倌	jwki
侬	jwti
佗	jwvb
倭	jxbn
斜	jxjd
俯	jxjk
俐	jxpd
叙	jxry
途	jxuc
您	jxyh
你	jxyx
俘	jyhi
侦	jyob
倒	jypd
俏	jyvy
禽	jzbv
创	jzpd
烫	kaec
汤	kaes
涛	kakc
涵	kakm
汛	kans
润	kanw
渍	kaob
涧	kaor
清	kavy
澜	kaxh
泓	kbks
汹	kbmk
淆	kbnv
流	kboc
涨	kbpc
溜	kbqt
澈	kbvh
浸	kbwr
溺	kbww
淡	kcch
潺	kchh
溃	kcob
湄	kcqm
漏	kctv
泥	kcvb
湖	kcvy
渥	kcyi
澡	kdde
怠	kdhx
涡	kdmj
涓	kdvy
淋	keem
淞	kehk
漆	kejk
海	kekm
渣	keof
湘	keqm
瀛	kfdi
沫	kfem
添	kfmh
浅	kfpg
沛	kfrj
沌	kfsc
漕	kfyo
洁	kgdk
洼	kggt
淳	kghi
漾	kgik
法	kgks
涤	khem
澎	khes
潜	khho
滋	khii
汾	khpd
溯	khsv
誉	khsy
涕	khtf
泌	khtp
举	khus
澄	khzd
潼	kidl
溉	kidu
浪	kiig
泳	kiks
滴	kimc
注	kinw
滂	kiwl
濮	kjci
洽	kjdk
涿	kjid
渝	kjvp
涂	kjxh
沧	kjzj
溢	kkam
治	kkdk
染	kkem
浚	kkhh
垒	kkkg
渗	kkme
涌	kkty
泄	klae
潇	klbh
灌	kldu
游	kleh
漩	klet
洪	klhb
港	klhv
淤	kljw
满	klml
漠	klom
滢	klwi
滞	klwr
涝	klws
污	kmae
参	kmes
洞	kmfd
潦	kmhy
汰	kmid
漪	kmmz
淹	kmoa
沅	kmpe
叁	kmts
淘	knaf
渎	knam
溥	knkc
沟	knks
渠	knne
洵	knor
潮	knov
瀚	knoz
滇	knqh
泡	knvs
渤	knws
温	koam
湿	kocy
沿	kodk
溅	kofp
涅	kogt
瀑	kolk
渴	konf
洲	kooc
测	kopd
淄	koqt
混	kovv
漫	koyr
沼	kpdk
浇	kpfp
梁	kphe
粱	kphp
涩	kpis
渊	kppm
滥	kpra
潞	kpsg
浩	kqdk
洗	kqpe
渭	kqvy
渺	kqyt
婆	krbn
涸	krcg
洄	krdk
沏	krpd
泾	krug
滩	krui
泽	krus
浒	ksen
泼	ksri
涉	kssi
濒	kssw
滚	kthk
恿	kthx
沃	ktmd
澳	ktmm
潘	ktpq
泛	ktri
勇	ktsl
涎	ktsu
通	ktuc
湃	kufa
激	kulh
浙	kutj
鸿	kuxn
漂	kvfs
湮	kvgt
湍	kvle
潭	kvon
浏	kvpd
熊	kvvc
能	kvvv
泞	kwad
觉	kwej
泻	kwf
泻	kwff
泻	kwfa
渲	kwff
渲	kwfx
演	kwfh
淙	kwfs
深	kwhe
溶	kwhg
学	kwhi
浣	kwmp
溟	kwoa
沉	kwoj
沈	kwpe
滨	kwth
浓	kwti
淀	kwts
浑	kwyc
漱	kxeq
涯	kxgg
濂	kxhc
渡	kxlr
涣	kxmm
漳	kxns
沥	kxsl
派	kxti
源	kxuy
濑	kxxo
澹	kxxs
泸	kycs
沾	kydk
淑	kyfr
浮	kyhi
溪	kyim
淖	kyon
滔	kypj
娑	kytb
淫	kytg
渐	kytj
沙	kytp
鲨	kytw
涟	kyuc
消	kyvy
漓	kzbv
湾	kzcb
滦	kzce
湛	kzha
淇	kzhb
滤	kzhx
淬	kzjn
液	kzjv
汴	kzyb
燕	ladc
莱	lahb
蒸	lakc
蒋	lalk
藉	lalo
藕	laqv
乖	lavb
菁	lavy
菇	lbcg
茹	lbdk
荨	lbkc
萧	lbph
蔚	lcfk
葫	lcvy
龌	lcyi
觐	ldae
勤	ldas
萼	ldda
鹳	lddx
施	leey
苯	lefi
苹	lehb
莓	lekm
旌	lels
族	leos
旅	leti
旋	lets
旗	lezh
茉	lfem
蒜	lffs
蔽	lfhp
荆	lflp
芋	lfns
荒	lfoc
蔷	lghd
菱	lghh
敬	lghp
警	lghs
擎	lghu
葬	lgvl
蓬	lhau
葵	lhfm
蔡	lhfs
荚	lhhb
蕊	lhhh
恭	lhhx
芬	lhpd
巷	lhvs
荪	lhyx
菩	lidk
薪	liet
药	lini
蕴	lioa
茅	litp
蒂	liwr
荟	ljby
葆	ljde
茶	ljem
蓓	ljid
苻	ljkc
苓	ljks
龄	ljk
荃	ljnw
芥	ljpd
花	ljvb
於	ljwb
荼	ljxh
苍	ljzj
荷	ljzk
荡	lkae
藻	lkde
苔	lkdk
萍	lkeh
茫	lkfw
蒲	lknf
薄	lknk
落	lksg
藩	lktq
莎	lkyt
范	lkzj
茗	lldk
董	lldl
垂	llgs
薰	llph
苑	llzj
芮	lmjr
莽	lmlc
英	lmmd
获	lmmq
藐	lmup
萄	lnaf
惹	lndh
若	lndk
葱	lneh
茬	lngg
荐	lngh
芍	lnid
葡	lnnf
荀	lnor
菊	lnpm
藏	lnqc
蕙	lnqh
苞	lnvs
莫	lomd
墓	lomg
慕	lomh
蓦	lomn
暮	lomo
幕	lomr
募	loms
摹	lomu
葛	lonf
草	lons
萌	lovy
鹊	loxn
蔓	loyr
蓝	lpra
著	lqor
甥	lqsl
茵	lrmd
茎	lrug
菌	lrxh
茄	lsdk
苏	lshb
蔼	lsof
荔	lsss
龇	lsvb
蔬	ltbo
蓑	ltdf
龋	ltdv
萨	ltix
孽	ltkh
薛	ltkn
蕃	ltpq
蕾	ltqt
荫	ltvy
蕉	luch
桀	lvem
藤	lvhk
散	lvhp
蒯	lvvp
萤	lwcc
荧	lwch
营	lwdd
荣	lwem
茨	lweq
萱	lwff
蒙	lwfj
藓	lwgy
蓉	lwhg
萦	lwis
蓿	lwju
莞	lwmp
莹	lwni
蓟	lwpd
带	lwrj
劳	lwsl
薇	lwvh
莺	lwxn
荤	lwyc
萎	lxbn
蕨	lxhe
蔗	lxlc
莉	lxpd
菜	lyem
萝	lylx
蔑	lyni
薯	lyqo
莲	lyuc
莲	lyul
蘸	lyuc
蘸	lyuv
怨	lzhx
蓄	lziq
萃	lzjn
蘑	lzms
鸳	lzxn
狡	mabi
专	maid
猜	mavy
爽	mbbb
网	mbbi
砥	mbid
碌	mbks
硫	mboc
刚	mbpd
砾	mbyx
碾	mclt
扈	mdmb
迥	mduc
砰	mehb
碴	meof
同	mfdk
研	mflc
硬	mfob
周	mgdk
猿	mgdt
雕	mgdu
奎	mggt
奎	mggd
硅	mggt
硅	mggs
磕	mgka
磋	mgug
猛	mham
肇	mhbv
碰	mhcy
罔	mhfw
狭	mhhb
磁	mhii
碘	mihb
态	mihx
狼	miig
遍	miuc
磅	miwl
翩	mizv
肉	mjjr
猴	mjno
碟	mlae
獾	mldu
猎	mlor
猫	mlqt
夸	mmae
砖	mmai
盎	mmam
碉	mmgd
獠	mmhy
飙	mmmb
磊	mmms
鸯	mmxn
碱	mnfd
豹	mnid
奔	mnlc
砸	mnrj
豺	mntp
逛	mnuc
奄	moae
碍	mofk
猩	mols
猖	moor
貂	mpdk
狮	mpfr
磷	mplv
远	mpuc
顽	mpwy
猓	mqem
猥	mqft
奢	mqor
奢	mqod
猪	mqor
猪	mqoq
砌	mrpd
础	msmk
狱	msmq
礁	much
貌	mupe
碑	mutn
碳	mvnc
狞	mwad
狩	mwkc
碗	mwlz
牵	mwqn
辉	mwyc
狰	mxbv
獗	mxhe
确	mxty
砧	mydk
砂	mytp
硝	myvy
彤	mzes
猝	mzjc
碎	mzjn
碎	mzjs
耀	mzui
盛	naam
骥	navh
卖	nawm
驳	nbbi
欧	nbeq
匈	nbmk
琉	nboc
殴	nbrs
鸥	nbxn
盔	ncam
璞	ncgi
瑕	ncmr
匮	ncob
瑚	ncvy
驶	ndbi
噩	nddd
骋	ndfa
囊	ndwt
琳	neem
忽	nehx
匆	neid
威	nfbn
感	nfdh
咸	nfdk
匐	nfdq
球	nfki
骊	nfvv
在	nggt
存	nghi
琼	ngyx
骈	nhlc
琅	niig
驻	ninw
珍	njes
琢	njid
驸	njkc
验	njkf
玲	njks
瑜	njvp
骏	nkhh
雄	nkui
瑾	nlda
璇	nlet
敷	nlhp
瑛	nlmm
匿	nlnd
贲	nlob
琊	nlte
献	nmgm
南	nmgy
匾	nmic
匾	nmik
骗	nmic
骗	nmim
玩	nmpe
琦	nmzk
琦	nmzw
骑	nmzk
骑	nmzm
驱	nnbi
瑟	nnht
琴	nnja
博	nnkc
琶	nnmb
琵	nnvv
乾	nona
韩	nong
斡	nonj
戟	nonp
朝	nonv
翰	nonz
瑁	noqm
瑙	notb
哉	npdk
栽	npem
骁	npfp
班	npnw
戴	npqh
璐	npsg
裁	npti
截	npui
载	npyc
矗	nqff
直	nqfi
真	nqhb
颠	nqhw
骡	nqis
惠	nqkh
瓒	nqpo
骤	nqrk
骚	nric
驿	nrus
协	nshb
珠	ntaw
骧	ntdf
骄	ntmp
碧	nums
骠	nvfs
瑞	nvle
刨	nvpd
郁	nvte
璀	nvui
琛	nwhe
孛	nwhi
勃	nwhs
索	nwis
琬	nwlz
驼	nwvb
璋	nxns
瑶	nyaf
玷	nydk
蹙	nyfp
戚	nyfy
琐	nyob
琏	nyuc
璃	nzbv
琪	nzhb
曳	oatp
晴	oavy
飕	obpr
飓	obqh
昂	obzj
暇	ocmr
昵	ocvb
邕	odmb
智	odor
晦	oekm
剁	oepd
晰	oetj
量	ofdl
昊	ofmd
贱	ofpg
赋	ofps
畅	ogae
煦	ogch
曦	ogxp
影	ogye
景	ogyx
景	ogyj
晾	ogyx
晾	ogyl
赚	ohbc
赠	ohro
赔	oidk
尬	ojpd
晔	ojvn
贻	okdk
暴	olhk
映	ommd
赎	onam
剔	onep
易	ones
歇	onfe
遏	onfu
购	onks
矩	onnk
财	ontp
贿	onvy
罂	ooaf
婴	oobn
鹦	oobx
曝	oolk
赐	oone
晶	ooor
照	opdc
昭	opdk
晓	opfp
贼	opns
尴	opra
晁	opww
巢	oqem
剿	oqep
鼻	oqlc
鼾	oqle
暑	oqor
暑	oqou
赌	oqor
赌	oqod
最	oqry
晌	otmd
矫	otmp
贬	otri
匙	otvb
题	otwy
凰	ounw
暹	ouuc
盟	ovam
昆	ovvb
晏	owbn
晤	owdk
暄	owff
贮	owfi
冕	owpe
冕	owpm
晚	owpe
晚	owpw
晕	owyc
晕	owyy
晖	owyc
晖	owyh
矮	oxbn
赃	oxgt
贩	oxry
赡	oxxs
贴	oydk
暖	oyfr
曙	oyqo
曼	oyry
暧	oywr
曜	ozui
跤	pabi
踌	pakc
断	patj
精	pavy
粥	pbbg
数	pbhp
踞	pccg
糊	pcvy
躁	pdde
惑	pdfh
或	pdfi
邵	pdte
迢	pduc
蹿	pedg
髻	pegd
髯	pemg
髦	pevm
鬃	pewf
鬓	pewh
尧	pfpe
践	pfpg
翘	pfpz
师	pfrj
糟	pfyo
糕	pgch
黠	pgdk
街	pggt
叟	pgry
粉	phpd
蹭	phro
蹲	phyk
蹬	phzd
忍	pihx
粮	piig
粮	piim
踉	piig
踉	piiu
黝	pisl
蹂	pite
胤	pivy
蹄	piwr
黔	pjae
趁	pjes
跄	pjzj
踏	pkor
踊	pkty
躏	plau
踵	pldl
粪	plhb
蹒	plml
躇	plqo
粼	plvo
跨	pmma
贰	pmob
距	pnnk
辨	pnnx
跋	pnri
跑	pnvs
跺	poem
踢	pone
蹋	pozv
超	ppdk
跷	ppfp
跳	ppww
糙	pqdu
踝	pqem
衢	pqqu
蹑	pqrr
趣	pqry
舅	pqsl
监	pram
览	prej
坚	prgt
竖	pril
紧	pris
贤	prob
临	pror
肾	prvy
鉴	przj
黜	psmk
鹭	psxn
跌	pthf
糯	ptle
跃	ptmd
毁	purs
踹	pvle
蹦	pvvv
衙	pwdk
踪	pwfs
兆	pwwb
逃	pwwu
糖	pxbd
趋	pxbj
糠	pxbk
踱	pxlr
跪	pxxz
粘	pydk
踩	pyem
舆	pyhb
蹊	pyim
蹈	pypj
粹	pzjn
鼎	qaap
饺	qabi
饲	qafd
睐	qahb
畴	qakc
瞰	qaqh
睛	qavy
馈	qcob
瞩	qctv
聘	qdfa
职	qdhb
靠	qdrf
造	qduc
鹄	qdxn
饰	qerj
饬	qesl
颗	qewy
考	qfae
睫	qfbs
盹	qfsc
畏	qfti
馐	qgag
睦	qghg
瞌	qgka
特	qgkc
聪	qhdh
睽	qhfm
教	qhhp
饼	qhlc
联	qhmd
盼	qhpd
畔	qhus
瞪	qhzd
瞳	qidl
睑	qjkf
聆	qjks
界	qjpd
馀	qjxh
饴	qkdk
眸	qkqn
睡	qllg
瞒	qlml
馍	qlom
瞄	qlqt
畸	qmzk
犊	qnam
物	qnes
眶	qnnw
饱	qnvs
煮	qoch
都	qote
馒	qoyr
饶	qpfp
睨	qppe
赞	qpqo
选	qpuc
眺	qpww
睹	qqor
瞿	qqui
娶	qrbn
制	qrpd
掣	qrpu
聂	qrry
聚	qrtk
瞠	qsgt
饷	qtmd
眨	qtri
饿	qtup
瞧	quch
熙	qvch
瞟	qvfs
愚	qvhx
遇	qvuc
毗	qvvb
瞎	qwad
馆	qwki
畹	qwlz
瞑	qwoa
眈	qwpe
耽	qwp
馋	qwpw
睁	qxbv
瞅	qxch
馅	qxpj
饭	qxry
瞻	qxxs
馁	qybn
睬	qyem
瞬	qywv
眩	qziy
筹	rakc
籍	ralo
简	raor
篆	rbjs
箓	rbks
箫	rbph
笋	rbtp
簪	rddo
帜	rdhb
圆	rdob
亟	rdrf
笨	refi
策	remk
箱	reqm
幅	rfdq
笺	rfpg
囤	rfsc
等	rgkc
筠	rgnw
篷	rhau
圈	rhhz
筷	rhnj
箭	rhvp
图	rhwb
蚤	ricc
幢	ridl
答	rjdk
筱	rjgh
符	rjkc
签	rjkf
筏	rjpg
簿	rknk
簇	rleo
筒	rmfd
恩	rmhx
篇	rmic
园	rmpe
箴	rnfd
国	rnid
筐	rnnw
团	rntp
帆	roid
幌	romg
帽	roqm
幔	royr
篓	rpbn
筛	rpfr
篮	rpra
篝	rqfg
算	rqlc
纂	rqmi
篡	rqmk
桑	rrre
叠	rrrf
笑	rtmd
幡	rtpq
筵	rtsu
箍	runr
筑	ruoi
劲	rusl
迳	ruuc
颈	ruwy
筋	rvsl
管	rwki
筝	rxbv
簌	rxeq
籁	rxxo
帖	rydk
箩	rylx
帧	ryob
篱	rzbv
箕	rzhb
簸	rzhr
词	safd
讯	sans
请	savy
诋	sbid
谈	scch
燮	sccr
谴	scku
谔	sdda
架	sdem
误	sdfm
识	sdhb
驾	sdnm
贺	sdob
袈	sdti
迦	sduc
讫	seai
评	sehb
诲	sekm
许	sens
蚩	sfcc
证	sfsi
诘	sgdk
谆	sghi
诗	sgkc
谅	sgyx
谦	shbc
谱	shco
说	shdp
讼	shks
谧	shta
议	sibi
谤	siwl
谛	siwr
谚	sixe
诊	sjes
诠	sjnw
讹	sjvb
谕	sjvp
谥	skam
诒	skdk
诵	skty
谍	slae
谨	slda
谎	slfo
诺	slnd
谟	slom
祟	smfs
调	smgd
讷	smjr
诳	smnw
诚	snae
读	snam
诙	snch
诀	snjr
辩	snnx
询	snor
讽	sobi
谒	sonf
谩	soyr
诏	spdk
谀	spjr
诫	splc
谜	spuc
试	spug
诰	sqdk
课	sqem
谡	sqhh
诸	sqor
谓	sqvy
发	srid
译	srus
频	sswy
诛	staw
诉	stid
诞	stsu
诬	sujj
柴	svem
紫	svis
些	svme
谭	svon
诣	svor
雌	svui
谐	svvu
语	swdk
谊	swfq
谗	swpw
诧	swtr
诿	sxbn
谏	sxhb
谄	sxpj
诱	sxvn
诡	sxxz
谣	syaf
让	syfi
谑	szbj
谋	szem
谌	szha
谬	szje
谢	szkc
衅	tahu
疏	tboc
裙	tbtd
霹	tcdn
霞	tcmr
襄	tddf
衰	tdfi
衷	tdgs
陨	tdob
禹	tdvr
襟	teef
霖	teem
霉	tekm
霜	teqm
袜	tfem
乓	tfid
褥	tfkc
陋	tfma
邱	tfte
乒	tftp
陌	tfub
岳	tfvs
鞋	tggt
褂	tggy
陵	tghh
丢	tgks
廷	tguy
隆	thfl
陕	thhb
隧	thju
乎	thns
雾	thsl
迭	thuc
降	thvk
霎	tibn
陪	tidk
袤	titp
褪	tiuc
褒	tjde
鞭	tjfb
坠	tjgt
附	tjkc
险	tjkf
零	tjks
袱	tjmq
阶	tjpd
靴	tjvb
除	tjxh
隘	tkam
阜	tkns
追	tkuc
龚	tlhb
向	tmdk
霾	tmdl
裔	tmhd
衲	tmjr
鞅	tmmd
乔	tmpd
阮	tmpe
奥	tmpm
鞑	tmuc
陶	tnaf
袂	tnjr
鞠	tnpm
隋	tnuv
堕	tnvg
袍	tnvs
袍	tnvi
雹	tnvs
雹	tnvv
随	tnvu
袒	tof
靼	tofi
靼	tofg
褐	tonf
褛	tpbn
釉	tpdy
悉	tphx
霓	tppe
番	tpq
鄱	tpqt
翻	tpqz
褴	tpra
释	tpru
露	tpsg
裸	tqem
裸	tqel
裹	tqem
裹	tqeg
褚	tqor
隅	tqvr
囱	trhi
粤	trpa
陈	tryx
霭	tsof
延	tsuy
霆	ttgu
袄	ttmd
霸	ttvy
亵	tuki
陆	tumk
我	tupg
鹅	tupx
裨	tutn
陛	tvvg
鞍	twbn
院	twmp
陀	twvb
隐	txbh
障	txns
陷	txpj
阪	txry
雳	txsl
裤	txyc
裆	tybj
睾	tygg
隙	tyoy
霄	tyvy
霄	tyvv
鞘	tyvy
鞘	tyvg
褶	tzub
皎	uabi
扬	uaes
扭	uagt
揍	uaim
捧	uaiu
拯	uakf
搁	uasg
挪	uaut
抵	ubid
撤	ubvh
抑	ubzj
据	uccg
摒	uchl
掘	ucsm
握	ucyi
操	udde
损	udob
揖	udqe
拐	udsl
捐	udvy
挖	ueai
拖	ueey
抨	uehb
控	ueug
巧	ufae
拜	ufaf
捷	ufbs
抹	ufem
撇	ufhp
段	ufrs
挂	uggt
持	ugkc
搓	ugug
掠	ugyx
揆	uhfm
挟	uhhb
撵	uhhy
拼	uhlc
掷	uhmt
扮	uhpd
掸	uhqn
拦	uhts
拌	uhus
接	uibn
撞	uidl
摘	uimc
拄	uinw
搬	uirs
拗	uisl
揉	uite
捻	ujah
拾	ujdk
挫	ujjg
巫	ujjr
捡	ujkf
拎	ujks
拴	ujnw
抢	ujzj
擒	ujzv
抬	ukdk
热	ukic
热	ukir
蛰	ukic
蛰	ukiv
执	ukid
垫	ukig
势	ukis
挚	ukiu
拚	uklc
掺	ukme
挨	ukos
抛	uksl
捅	ukty
挝	ukuc
搅	ukwe
拱	ulhb
邀	ulhu
搭	uljd
捶	ullg
摸	ulom
措	ulor
插	ulpj
描	ulqt
撒	ulvh
捞	ulws
捺	umfs
撩	umhy
挎	umma
皋	umns
翱	umnz
掩	umoa
掏	unaf
抠	unbi
撼	unfh
的	unid
抉	unjr
搏	unkc
拒	unnk
掬	unpm
拔	unri
抱	unvs
拽	uoat
捍	uoeg
担	uofi
捏	uogt
巩	uoid
恐	uoih
揭	uonf
撮	uoqr
提	uots
擞	upbh
搂	upbn
招	updk
挠	upfp
搜	upgr
揽	upre
拭	upug
挑	upww
皓	uqdk
拷	uqfa
摞	uqis
攒	uqpo
攫	uqqr
摄	uqrr
撂	uqsg
捆	urem
搔	uric
攥	urqi
摊	urui
择	urus
拣	uryx
拙	usmk
拨	usri
撑	usus
攘	utdf
哲	utdk
掀	uteq
挺	utgu
拆	utid
卑	utns
播	utpq
擂	utqt
托	utrq
誓	utsy
逝	utuc
携	uuvn
拟	uvjr
揣	uvle
指	uvor
摧	uvui
批	uvvb
撰	uvvh
皑	uvvj
揩	uvvu
撬	uvvv
拧	uwad
按	uwbn
捂	uwdk
探	uwhe
擦	uwhf
皖	uwmp
撸	uwor
挽	uwpe
搀	uwpw
挥	uwyc
搪	uxbd
挣	uxbv
揪	uxch
捱	uxgg
撅	uxhe
换	uxmm
掐	uxpj
扳	uxry
扳	uxrs
皈	uxry
皈	uxrb
捣	uxvs
掂	uxyd
扼	uxzj
摇	uyaf
挡	uybj
拈	uydk
援	uyfr
摆	uygk
捋	uykc
掉	uyon
抄	uytp
捎	uyvy
授	uywr
撕	uzht
摔	uzin
搐	uziq
掖	uzjv
抗	uzoj
擅	uzrf
报	uzry
掳	uzsl
擢	uzui
胶	vabi
肠	vaes
斓	vaxh
氯	vbks
腱	vbuy
毯	vcch
毯	vccm
氮	vcch
氮	vccq
胚	vcfi
氪	vcpe
嵋	vcqm
崛	vcsm
臊	vdde
肿	vdgs
屹	veai
膝	vejk
腹	veoh
崆	veug
崆	veus
腔	veug
腔	veuy
屿	vfaf
飘	vfob
剽	vfpd
斌	vfps
肺	vfrj
瓢	vfyg
膳	vghd
峙	vgkc
脚	vgkz
甄	vgrw
峰	vhaf
脱	vhdp
膨	vhes
峡	vhhb
滕	vhhk
腾	vhhn
朕	vhmd
氛	vhpd
胖	vhus
腆	vihb
幽	viiy
脉	viks
腿	viuc
膀	viwl
岑	vjae
脸	vjkf
岭	vjks
胎	vkdk
峻	vkhh
颍	vkwy
膜	vlom
腊	vlor
朦	vlwj
崂	vlws
胰	vmbg
岗	vmbi
然	vmch
胯	vmma
腌	vmoa
崎	vmzk
岖	vnbi
胸	vnbm
炭	vnch
膊	vnkc
斑	vnnw
巅	vnqw
胞	vnvs
脖	vnwh
氲	voam
岚	vobi
胆	vofi
疑	vokt
腥	vols
覃	vons
腻	vpmo
崽	vqhx
崽	vqhs
腮	vqhx
腮	vqhy
盈	vram
胭	vrmd
氢	vru
胫	vrug
胫	vruy
膛	vsgt
胁	vshb
峨	vtup
腺	vuks
脾	vutn
腰	vvbn
觊	vvej
毙	vvgv
毕	vvns
凯	vvoj
脂	vvor
皆	vvub
崩	vvvy
鹏	vvxn
氨	vwbn
氨	vwbq
胺	vwbn
胺	vwby
覆	vweh
崇	vwfs
腕	vwlz
脓	vwti
巍	vxba
岸	vxeg
崖	vxgg
脏	vxgt
臆	vxhx
腑	vxjk
颖	vxwy
脆	vxxz
毡	vydk
崭	vytj
峭	vyvy
脑	vzbm
嵌	vzeq
臃	vziu
腋	vzjv
肮	vzoj
服	vzry
寐	waaw
寝	wabr
豁	wadh
害	wadk
割	wadp
凑	waim
御	wazj
案	wbem
鳄	wdda
宫	wddk
冲	wdgs
况	wdpe
盗	weam
姿	webn
咨	wedk
恣	wehx
资	weob
瓷	werw
写	wfaf
凄	wfbb
寅	wfdh
富	wfdq
宇	wfns
宣	wfof
惩	wfsh
征	wfsi
凌	wghh
待	wgkc
冽	wgpd
凉	wgyx
凉	wgyb
鲸	wgyx
鲸	wgyv
罕	wheg
察	whfs
蜜	whtc
宓	whtp
密	whtv
後	wihi
往	winw
鲫	wizj
宿	wjfu
冢	wjid
冷	wjks
徐	wjxh
冶	wkdk
宽	wlej
寞	wlom
宛	wlzj
凋	wmgd
完	wmpe
寇	wmph
冠	wmpk
寄	wmzk
减	wnfd
宝	wnid
决	wnjr
宏	wnks
徇	wnor
鲍	wnvs
德	wnyh
冥	woal
宴	wobn
得	wofk
审	wogs
鲲	wovv
鳗	woyr
鳎	wozv
鳞	wplv
勉	wpsl
寨	wqhe
塞	wqhg
赛	wqho
寒	wqhw
鳃	wqhx
鳍	wqor
宪	wqpe
寓	wqvr
徊	wrdk
彻	wrpd
径	wrug
冻	wryx
徙	wssi
额	wswy
宾	wthb
宅	wtrq
徨	wunw
鹤	wuxn
徽	wvfi
徵	wvfn
微	wvfo
凝	wvot
脊	wwjv
实	wwmd
寡	wwpd
净	wxbv
循	wxnq
鲇	wydk
寂	wyfr
寰	wyft
宵	wyvy
寥	wzje
凛	wzrf
乘	xavb
剩	xavp
魏	xbag
唐	xbdk
煞	xbhc
急	xbhx
底	xbid
赓	xbjo
庚	xbjr
康	xbks
稀	xbnr
皱	xbrp
邹	xbte
庸	xbty
雏	xbui
愁	xchx
种	xdgs
积	xdhb
程	xdnw
秤	xehb
厢	xeqm
后	xfdk
厦	xfoh
厉	xfpd
励	xfps
秸	xgdk
穑	xghd
廓	xght
压	xgid
廉	xhbc
税	xhdp
整	xhfs
厥	xhse
秘	xhtp
灸	xich
厩	xidu
廊	xiit
座	xjjg
府	xjkc
黏	xjkd
腐	xjkj
雁	xjui
膺	xjuv
鹰	xjux
应	xkfi
庶	xlch
遮	xlcu
移	xllx
席	xlrj
度	xlry
魇	xmag
靥	xmbm
稠	xmgd
奂	xmm
秧	xmmd
秧	xmmh
庵	xmoa
彰	xnes
赣	xnho
质	xnob
穗	xnqh
盾	xnqm
遁	xnqu
庖	xnvs
韵	xnwb
厚	xohi
厕	xopd
稽	xovo
嵇	xovs
颓	xowy
韶	xpdk
梨	xpem
黎	xpjk
麟	xplv
犁	xpqn
稷	xqhh
返	xruc
废	xsri
触	xtcc
庭	xtgu
秩	xthf
斛	xtjd
蟹	xtpc
解	xtpq
穆	xuye
愿	xuyh
原	xuyx
秽	xvlx
透	xvuc
庇	xvvb
稼	xwjs
鸵	xwvb
稳	xxbh
詹	xxhs
赖	xxob
称	xxyx
危	xxzj
店	xydk
玺	xyni
稻	xypj
秒	xytp
迩	xyuc
稍	xyvy
麒	xzhb
厮	xzht
廖	xzje
厨	xzk
麝	xzkc
麝	xzkl
顾	xzwy
较	yabi
臻	yaix
遥	yauc
鹞	yaxn
酗	ybmk
辙	ybvh
辗	yclt
颅	ycwy
点	ydch
战	ydpg
辑	ydqe
彩	yees
酶	yekm
辐	yfdq
忐	yfhx
罡	yfsi
卡	yfyb
督	yfyq
叔	yfyr
辕	ygdt
醇	yghi
罢	ygks
乳	yhae
罹	yhui
酿	yiig
奚	yimd
输	yjvp
酸	ykhh
醋	ylor
醺	ylph
逻	yluc
转	ymai
酮	ymfd
蜀	yncc
酌	ynid
瓣	ynnx
置	ynqf
桌	yoem
醒	yols
卓	yons
酬	yooc
辎	yoqt
轼	ypug
辄	yqae
酷	yqdk
酵	yqhi
署	yqor
酰	yqpe
卤	yrbi
辍	yrrr
轰	yrry
轻	yrug
罚	yspd
堑	ytgt
轶	ythf
轿	ytmp
羁	ytnm
暂	ytor
省	ytqm
劣	ytsl
醮	yuch
削	yvpd
逍	yvuc
辖	ywad
舜	ywlv
爱	ywnr
受	ywry
爵	yyik
罩	yyon
醉	yzjn
钮	zagt
铸	zakc
锵	zalk
锏	zaor
离	zbmv
键	zbuy
弯	zcbg
蛮	zccc
锯	zccg
觑	zcej
栾	zcem
孪	zchi
恋	zchx
弈	zclc
奕	zcmd
变	zcry
迹	zcuc
挛	zcus
峦	zcvs
鸾	zcxn
銮	zczj
锷	zdda
铝	zddk
虞	zdfm
钟	zdgs
锅	zdmj
钵	zefi
钱	zfpg
钝	zfsc
锄	zfsl
钙	zfya
镁	zgmd
甚	zhae
锋	zhaf
斟	zhaj
锰	zham
勘	zhas
锐	zhdp
欺	zheq
基	zhgt
斯	zhtj
期	zhvy
畜	ziqt
雍	ziui
镑	ziwl
率	ziwn
铲	zixc
戮	zjep
卒	zjjn
铃	zjks
遽	zjuc
夜	zjvy
铭	zldk
锺	zldl
锤	zllg
错	zlor
锚	zlqt
钢	zmbi
铜	zmfd
镣	zmhy
钛	zmid
钠	zmjr
躯	znbi
钓	znid
钩	znks
镇	znqh
钧	znwb
铅	zodk
躲	zoem
锡	zone
镂	zpbn
铿	zprg
铐	zqfa
翼	zqlh
锢	zrcg
禀	zrdf
颤	zrdw
钗	zrid
铎	zrus
铢	ztaw
镶	ztdf
铁	zthf
麽	ztks
镭	ztqt
锻	zufr
戳	zupg
锦	zurj
镌	zuvn
镖	zvfs
铠	zvvj
豌	zwlz
锭	zwts
铮	zxbv
锹	zxch
镰	zxhc
镀	zxlr
镜	zxpe
锈	zxvn
铛	zybj
钻	zydk
锣	zylx
镯	zync
锁	zyob
钞	zytp
链	zyuc
销	zyvy
歌	zzeq
翠	zzjn
鑫	zzzj
